# danh từ
they: họ
we: chúng tôi
i am: tôi
you: bạn
your: của bạn
my: của tôi

# vị trí
on: bật, ở
in: ở
the: cái đó
that: cái kia
here: ở đây
today: hôm nay
at home: ở nhà
at school: ở trường

# tính từ
really: thật sự
also: cũng
like: thích
want: muốn
need: cần
a little: 1 chút
study: học
oh: oh
understand: hiểu
speak: nói
very: rất
right: phải, đúng không
yes: vâng
too: cũng
and: và
with: với
or: hoặc

# miêu tả
good: tốt
beautiful: đẹp
smart: thông minh
fun: vui vẻ
cute: dễ thương
new: mới
cheap: rẻ
well: tốt
great: tuyệt vời
delicious: ngon
large: lớn
small: nhỏ
expensive: đắt
old: cũ, già
quiet: yên tĩnh
famous: nổi tiếng
busy: bận, đông đúc
nice: tốt
big: lớn

# cấu trúc
who is: ai là
here is: đây là
how much is: bao nhiêu
i have: tôi có
do you have: bạn có
it is: nó là
is it: nó là
i'd like a: tôi muốn 1
where is: ở đâu
this is: đây là
is this: đây là
my name is: tôi tên là
and you: còn bạn
i am from: tôi đến từ

# chào hỏi
nice to meet you: rất vui được gặp
see you later: hẹn gặp lại
have a seat: mời ngồi
how are you: bạn có khỏe không
come in: mời vào
i am good: tôi khỏe
dont worry: đừng lo
here is your: của bạn đây
excuse me: xin làm phiền
welcome to: chào mừng đến
hi: chào
hello: chào
goodbye: tạm biệt
thank you: cảm ơn
please: làm ơn

# bạn bè
friend: bạn bè
party: tiệc
classmate: cùng lớp
together: cùng nhau
roommate: cùng phòng
class: lớp

# đồ ăn
cake: bánh ngọt
food: đồ ăn
dessert: tráng miệng
bowl of soup: tô súp
salad: sa lát
burger: bánh mỳ kẹp thịt
glass of water: ly nước
pizza: pizza
sandwich: bánh mỳ kẹp
water: nước
sugar: đường
milk: sữa
tea: trà
coffee: cà phê

# khoảng cách
near: gần

# đồ đạc
wallet: ví
fridge: tủ lạnh
couch: sô pha
table: bàn
phone: điện thoại
bag: túi, cặp
ticket: vé
passport: hộ chiếu

# đồ mặc
skirt: váy
shirt: áo
sweater: áo len
scarf: khăn quàng
hat: mũ
jacket: áo khoác

# phòng
bathroom: nhà vệ sinh
kitchen: phòng bếp
living room: phòng khách
apartment: căn hộ
library: thư viện

# phương tiện
car: ô tô

# vệ sinh
clean: sạch, dọn dẹp

# màu sắc
green: xanh lá
white: màu trắng
red: màu đỏ

# cửa hàng
closed: đóng cửa
open: mở cửa
on sale: giảm giá
store: cửa hàng
check: xem, hoá đơn
menu: thực đơn
restaurant: nhà hàng

# động vật
snake: rắn
rabbit: thỏ
cat: mèo
pet: thú cưng
dog: chó

# số đếm
three: 3
two: 2

# thời tiết
windy: nhiều gió
cloudy: nhiều mây
hot: nóng
sunny: nắng
cold: lạnh
rainy: mưa

# quốc gia
chinese: tiếng trung
spanish: tiếng tây ban nha
english: tiếng anh
france: pháp

# nghề nghiệp
lawyer: luật sư
nurse: y tá
teacher: giáo viên
professor: giáo sư
chef: đầu bếp
student: học sinh
doctor: bác sĩ

# gia đình
husband: chồng
wife: vợ
brother: anh em trai
sister: chị em gái
mom: mẹ
dad: bố

# thành phố
park: công viên
university: đại học
house: nhà
street: đường phố
museum: bảo tàng
city: thành phố
customs: hải quan
gate: cổng
